"filename", "language", "Java", "JavaScript", "comment", "blank", "total"
"/Users/darrellparkhouse/projects/leet-code/Java/medium/swap-nodes-in-pair.java", "Java", 15, 0, 0, 3, 18
"/Users/darrellparkhouse/projects/leet-code/easy/list-has-cycle.js", "JavaScript", 0, 10, 7, 0, 17
"/Users/darrellparkhouse/projects/leet-code/easy/path-sum.js", "JavaScript", 0, 0, 14, 0, 14
"/Users/darrellparkhouse/projects/leet-code/easy/singleNumber.js", "JavaScript", 0, 7, 7, 0, 14
"/Users/darrellparkhouse/projects/leet-code/easy/sortArraytoBST.js", "JavaScript", 0, 0, 1, 0, 1
"/Users/darrellparkhouse/projects/leet-code/easy/valid-palindrome.js", "JavaScript", 0, 20, 7, 1, 28
"/Users/darrellparkhouse/projects/leet-code/hard/candy.js", "JavaScript", 0, 0, 31, 1, 32
"/Users/darrellparkhouse/projects/leet-code/hard/directed-graph/dijkstra.js", "JavaScript", 0, 31, 19, 1, 51
"/Users/darrellparkhouse/projects/leet-code/hard/directed-graph/kosaraju.js", "JavaScript", 0, 47, 20, 1, 68
"/Users/darrellparkhouse/projects/leet-code/hard/directed-graph/tarjan.js", "JavaScript", 0, 39, 14, 1, 54
"/Users/darrellparkhouse/projects/leet-code/hard/find-median-sorted-array.js", "JavaScript", 0, 0, 8, 0, 8
"/Users/darrellparkhouse/projects/leet-code/medium/,aax-area.js", "JavaScript", 0, 29, 9, 4, 42
"/Users/darrellparkhouse/projects/leet-code/medium/swap-pairs.js", "JavaScript", 0, 15, 0, 4, 19
"Total", "-", 15, 198, 137, 16, 366